xxxxxxxxxxxxxxxxxxxxxxxxxxxxxxxxxxxxxxxxxxxxxxxxxxxxxxxxxxxxxxxxxxx
x                                                                 x
x xxx x x x  xx  x  xx    x  x   xx xxx   x    xx xxx  x  xx  xxx x
x  x  xxx x  x   x  x   x x xxx  x   x   xxx   x   x  xxx x x  x  x
x  x  x x x xx   x xx    x  x x xx   x   x x  xx   x  x x x x  o  x
x               o                                                 x
x   p                                                             x
x               -            + +   . #  #  #  # .                xx
xxxxxxxxxx!!!!!xxx!!!!!!xxxxxx!xx!!!xxxxxxxxxxxxxxxxxxxxxxxx!!!!!xx