xxxxxxxxxxxxxxxxxxxxxxxxxxxxxxxxxxxxxxxxxxxxxxxxxxxxxxxxxxxxxxxxxxx
x                                                                ox
x       o                                                        xx
x                  o         o          o                         x
x   x!!!!xxxx     xxx   o   xxx        xxx      x      x      x   x
x -                     x                                         x
xxxxxxxxxx                       ! + !                           xx
x         x                      !   !      o                     x
x   p      xx                    !   !   x!!!!!x              x   x
x     .    #  .                  x   x    xxxxx   #   .           x
xxxxx!!xxxxxxxx!!!!!!!!!!!xxxxxxxx   xxxxxxxxxxxxxxxxx!!!!xxxxx  xx
x   xxxx      xxxxxxxxxxxxx                o  o      xxxxxx  ox   x
x o                                                           xx  x
x   .  #      #  .                 +   xxx    #    xxx   -        x
x!!!xxxxxxxxxxxxxxxxxxxxxxxxx!!!xxxxxxxxxxxxxxxxxxxxxxxxxxxxxxxxxxx