xxxxxxxxxxxxxxxxxxxxxxxxxxx
x                         x
x   p    x  x  x  x       x
x        x  x x x x       x
x        xx x x x x    o  x
x        x xx x x         x
x        x  x  x  x       x
x    .        #   -   #   x
xxx!!!xxxxxxxxxxxxxxxxxxxxx