xxxxxxxxxxxxxxxxxxxxxxxxxxx
x        o                x
x   p                     x
x       .#  #  . +        x
x       xxxxxxxxxxx    o  x
x        x                x
x        xxxx  xx x       x
x    .        #   -   #   x
xxx!!!xxxxxxxxxxxxxxxxxxxxx