xxxxxxxxxxxxxxxxxxxxxxxxxxx
x                         x
xo                       ox
x  o                   o  x
x                         x
xx           !           xx
x   x  o           o  x   x
x  #  .      p      .  #  x
xxxxxx!!!xxxxxxxxx!!!xxxxxx