xxxxxxxxxxxxxxxxxxxxxxxxxxxxxxxxxxxxxxxxxxxxxxxxxxxxxxxxxxxxxxxxxx
x   x  x  x  x  x  x  x  x  x  x  x  x  x  x  x  x  x  x  x  x   x
x   !  !  !  !  !  !  !  !  !  !  !  !  !  !  !  !  !  !  !  !   x
x                                                                x
x                                                             o  x
x               o                                                x
x   p                                                            x
x               -            + +   . #  #  #  # .               xx
xxxxxxxxxx!!!!!xxx!!!!!!xxxxxx!xx!!!xxxxxxxxxxxxxxxxxxxxxxx!!!!!xx