xxxxxxxxxxxxxxxxxxxxxxxxxxx
x                         x
x            x            x
x           xxx           x
x          x x x          x
x            x            x
xo           p           ox
x                         x
xxxxxx!!!xxxxxxxxx!!!xxxxxx